team,position,games_played,wins,draws,losses,points,gf,ga,gd
Bayern Munich,1,34,21,7,6,70,89,45,44
RB Leipzig,2,34,20,9,5,69,72,33,39
Leverkusen,3,34,19,9,6,66,81,41,40
Dortmund,4,34,13,14,7,53,68,59,9
Stuttgart,5,34,14,11,9,53,53,47,6
Freiburg,6,34,14,10,10,52,60,52,8
Eintracht Frankfurt,7,34,15,7,12,52,59,62,-3
Union Berlin,8,34,13,9,12,48,52,41,11
Wolfsburg,9,34,13,8,13,47,67,60,7
Hoffenheim,10,34,13,8,13,47,59,55,4
Augsburg,11,34,13,6,15,45,44,67,-23
Mainz 05,12,34,12,8,14,44,45,51,-6
St Pauli,13,34,11,9,14,42,32,33,-1
Gladbach,14,34,11,5,18,38,54,63,-9
Heidenheim,15,34,7,11,16,32,47,73,-26
Hamburger SV,16,34,9,5,20,32,36,64,-28
Koln,17,34,8,5,21,29,41,79,-38
Werder Bremen,18,34,7,5,22,26,38,72,-34
